########
#      #
# .  $ #
# ..$  #
# . $$ #
#   @  #
########