#######
#     #
# .$. #
# $$  #
# .@  #
#######