#######
# . . #
#   $ #
# $   #
# # # #
#  @  #
#######