  ###############
  #      @      #
###  #$     $#  ###
#   ##  ###  ##   #
#  $##$ .#. $##$  #
#    #  .#.  #    #
#       .#.       #
##  #   ###   #  ##
 # $##### #####$ #
##  #   ###   #  ##
#       .#.       #
#    #  .#.   #$  #
#  $##  .#. $##   #
#   ##  ###  ##   #
###  #   $    # ###
  #             #
  ###############