########
#      #
# . $  #
# .$$. #
#  $ . #
#  @   #
########