#######
#  .  #
# $   #
# # # #
# @   #
#######