 ########################        
          ##                     #        
          # $.$.$.$.$.$.$.$.$.$.##        
          # .$.$.$.$.$.$.$.$.$.$ #        
          # $.$.$.$.$.$.$.$.$.$. #        
          # .$.$.$.$.$.$.$.$.$.$ #        
          # $.$.$.$.$.$.$.$.$.$. #        
          # .$.$.$.$.$.$.$.$.$.$ #        
          # $.$.$.$.$.$.$.$.$.$. #        
          # .$.$.$.$.$.$.$.$.$.$ #        
          # $.$.$.$.$.$.$.$.$.$. #        
          # .$.$.$.$.$.$.$.$.$.$ #        
          # $.$.$.$.$.$.$.$.$.$. #        
          # .$.$.$.$.$.$.$.$.$.$ #        
          # $.$.$.$.$.$.$.$.$.$. #        
          # .$.$.$.$.$.$.$.$.$.$ #        
          # $.$.$.$.$.$.$.$.$.$. #        
          # .$.$.$.$.$.$.$.$.$.$ #        
          # $.$.$.$.$.$.$.$.$.$. #        
########### .$.$.$.$.$.$.$.$.$.$ #########
##     #### $.$.$.$.$.$.$.$.$.$. ###     #
##.* $ #### .$.$.$.$.$.$.$.$.$.$ ###.* $ #
## ## #####@                    #### ## ##
## #      ############ #############  # ##
## ######                            ## ##
#  #    ############## ###############   #
# ## ## #      #       #      #     ## ###
#   . # ## ##  ## ## #### ##  ## ##   . ##
# # * #   . #    . # #   . #    . # #$.$##
# # * # #$.$#  #$.$# # #$.$#  #$.$# # * ##
# # * # # * #  # * # # # * #  # * # # * ##
# # * # # * #  # * # # # * #  # * # # * ##
# # * # # * #  # * # # # * #  # * # # * ##
# # * # # * #  # * # # # * #  # * # # * ##
# # * # # * #  # * # # # * #  # * # # * ##
# # * # # * #  # * # # # * #  # * # # * ##
# # * # # * #  # * #   # * #  # * # # * ##
# # * ### * # ## * # ### * #  # * # # * ##
### *  #  $ ###  * ###   $.# ## * ### *  #
##  $  # .*  ##  $  ## ..* ###  * ##  *  #
# .$** ##.*   # ** . ##  $  # . *  #  $ ##
# #  #### $   ###  # ### $  #   $  ## . ##
#   #######  #####   ####  #####  ####  ##
##########################################