###########
#    #    #
# $  #  . #
#  #####  #
# $  #  . #
#    #    #
# $  #  . #
#  #####  #
# $  @  . #
#         #
###########